111111111
1r0000001
101101101
101101101
100000001
101101101
101101101
1000000b1
111111111